feuilles	replicat	M0_t0_glu	M0_t120_glu	M0_t0_val	M0_t120_val	pourcentage_enri_glu	pourcentage_enri_val	diff√©rence-enri
15	A	100	77	100	86	23	14	9
15	B	100	79	100	86	21	14	7
15	C	100	77	100	88	23	12	11
11	A	100	81	100	97	19	3	16
11	B	100	79	100	96	21	4	17
11	C	100	81	100	91	19	9	10
7	A	100	80	100	99	20	1	19
7	B	100	78	100	99	22	1	21
7	C	100	83	100	97	17	3	14
3	A	100	82	100	99	18	1	17
3	B	100	73	100	99	27	1	26
3	C	100	79	100	98	21	2	19